10
5
15
150
0000000000
0000000000
0000000000
0000000000
0000000000
0000100100
0010101100
0010111100
1010111101
1111111111
