9
6
12
200
000000000
000000000
000000000
000000000
000000000
100000001
100101001
101111101
111111111
