9
6
11
250
000000000
000000000
000000000
000000000
001101100
101101101
101101101
101101101
111111111
