8
6
10
00000000
10000000
10000100
10000100
10000100
10001100
10011110
10111111
